Abandonado| s. y adj. El que no tiene favores que otorgar. Desprovisto de fortuna. Amigo de la verdad y el sentido común.
Abdicación| s. Acto mediante el cual un soberano demuestra percibir la alta temperatura del trono.
Abdomen| s. Templo del dios Estómago
Aborígenes| s. Seres de escaso mérito que entorpecen el suelo de un país recién descubierto. Pronto dejan de entorpecer; entonces
Abrupto| adj. Repentino
Absoluto| adj. Independiente
Abstemio| s. Persona de carácter débil
Absurdo| s. Declaración de fe en manifiesta contradicción con nuestra opiniones. Adj. Cada uno de los reproches que se hacen a este excelente diccionario.
Aburrido| adj. Dícese del que habla cuando uno quiere que escuche.
Academia| s. Escuela antigua donde se enseñaba moral y filosofía. Escuela moderna donde se enseña el fútbol.
Accidente| s. Acontecimiento inevitable debido a la acción de leyes naturales inmutables.
Acéfalo| adj. Lo que se encuentra en la sorprendente condición de aquel cruzado que
Acorde| s. Armonía.
Acordeón| s. Instrumento en armonía con los sentimientos de un asesino.
Acreedor| s. Miembro de una tribu de salvajes que viven más allá del estrecho de las Finanzas; son muy temidos por sus devastadoras incursiones.
Acusar| v.t. Afirmar la culpa o indignidad de otro; generalmente
Adagio| s. Sabiduría deshuesada para dentaduras débiles.
Adherente| s. Secuaz que todavía no ha obtenido lo que espera.
Adivinación| s. Arte de desentrañar lo oculto. Hay tantas clases de adivinación como variedades fructíferas del pelma florido y del bobo precoz.
Administración| s. En política
Admiración| s. Reconocimiento cortés de la semejanza entre otro y uno mismo.
Admitir| v. t. Confesar. Admitir los defectos ajenos es el deber más alto que nos impone el amor de la verdad.
Admonición| s. Reproche suave o advertencia amistosa que suele acompañarse blandiendo un hacha de carnicero.
Adoración| s. Testimonio que da el Homo Creator de la sólida construcción y elegante acabado del Deus Creatus. Forma popular de la abyección que contiene un elemento de orgullo.
Adorar| v t. Venerar de modo expectante.
Aflicción| s. Proceso de aclimatación que prepara el alma para otro mundo más duro.
Aforismo| s. Sabiduría predigerida.
Africano| s. Negro que vota por nuestro partido.
Agitador| s. Estadista que sacude los frutales del vecino… para desalojar a los gusanos.
Aire| s. Sustancia nutritiva con que la generosa Providencia engorda a los pobres.
Alá| s. El Supremo Ser Mahometano por oposición al Supremo Ser Cristiano
Alba| s. Momento en que los hombres razonables se van a la cama. Algunos ancianos prefieren levantarse a esa hora
Alianza| s. En política internacional la unión de dos ladrones cada uno de los cuales ha metido tanto la mano en el bolsillo del otro que no pueden separarse para robar a un tercero.
Alma| s. Entidad espiritual que ha provocado recias controversias. Platón sostenía que las almas que en una existencia previa (anterior a Atenas) habían vislumbrado mejor la verdad eterna
Almirante| s. Parte de un buque de guerra que se encarga de hablar
Altar| s. Sitio donde antiguamente el sacerdote arrancaba
Ambición| s. Deseo obsesivo de ser calumniado por los enemigos en vida
Ambidextro| adj. Capaz de robar con igual habilidad un bolsillo derecho que uno izquierdo.
Amistad| s. Barco lo bastante grande como para llevar a dos con buen tiempo
Amnistía| s. Magnanimidad del Estado para con aquellos delincuentes a los que costaría demasiado castigar.
Amor| s. Insania temporaria curable mediante el matrimonio
Ancianidad| s. Epoca de la vida en que transigimos con los vicios que aún amamos
Anormal| adj. Que no responde a la norma. En cuestiones de pensamiento y conducta ser independiente es ser anormal y ser anormal es ser detestado. En consecuencia
Antiamericano| adj. Perverso
Antipatía| s. Sentimiento que nos inspira el amigo de un amigo.
Año| s. Período de trescientos sesenta y cinco desengaños.
Apelar| v. i. En lenguaje forense
Apetito| s. Instinto previsor implantado por la Providencia como solución al problema laboral.
Aplauso| s. El eco de una tontería. Monedas con que el populacho recompensa a quienes lo hacen reír y lo devoran.
Apóstata| s. Sanguijuela que tras penetrar en el caparazón de una tortuga y descubrir que hace mucho que está muerta
Arado| s. Implemento que pide a gritos manos acostumbradas a la pluma.
Árbol| s. Vegetal alto
Ardor| s. Cualidad que distingue al amor inexperto.
Arena| s. En política
Aristocracia| s. Gobierno de los mejores. (En este sentido la palabra es obsoleta
Armadura| s. Vestimenta que usa un hombre cuyo sastre es un herrero.
Arquitecto| s. El que traza los planos de nuestra casa y planea el destrozo de nuestras finanzas.
Arrepentimiento| s. Fiel servidor y secuaz del Castigo. Suele traducirse en una actitud de enmienda que no es incompatible con la continuidad del pecado.
Arruinar| v. t. Destruir. Específicamente
Arsénico| s. Especie de cosmético a que son afectas las mujeres y que
Arzobispo| s. Dignatario eclesiástico un punto más santo que un obispo.
Asilo| s. Todo lo que asegura protección a alguien en peligro: Moisés y Josué establecieron seis ciudades de asilo –Beze
Asno| s. Cantante público de buena voz y mal oído. En Virginia City
Astucia| s. Cualidad que distingue a un animal o persona débil de otro fuerte. Acarrea a su poseedor gran satisfacción intelectual
Audacia| s. Una de las cualidades más evidentes del hombre que no corre peligro.
Ausente| adj. Singularmente expuesto a la mordedura de la calumnia; vilipendiado; irremediablemente equivocado; sustituido en la consideración y el afecto de los demás.
Ausentista| adj. Dícese del propietario lo bastante precavido para alejarse del territorio de sus exacciones.
Australia| s. País situado en los Mares del Sur
Autoestima| s. Evaluación errónea.
Autoevidente| s. Evidente para uno mismo y para nadie mas.
Averno| s. Lago por el cual los antiguos entraban en las regiones infernales. El erudito Marcus Ansello Scrutator sostiene que de ahí deriva el rito cristiano del bautismo por inmersión. Lactancio
Avestruz| s. Ave de gran tamaño
Ayer| s. Infancia de la juventud
Baal| s. Antigua deidad muy venerada bajo distintos nombres. Como Baal era popular entre los fenicios; como Belus o Bel tuvo el honor de ser servido por el sacerdote Berosus
Baco| s. Cómoda deidad inventada por los antiguos como excusa para emborracharse.
Bailar| v. i. Saltar a compás de una música alegre
Baño| s. Especie de ceremonia mística que ha sustituido al culto religioso. Se ignora su eficacia espiritual.
Barba| s. El pelo que suelen cortarse los que justificadamente abominan de la absurda costumbre china de afeitarse la cabeza.
Barómetro| s. Ingenioso instrumento que nos indica qué clase de tiempo tenemos.
Basilisco| s. Cocatriz. Especie de serpiente empollada en el huevo de un gallo. El basilisco tenía un mal ojo y su mirada era letal. Muchos infieles niegan la existencia de este ser
Bastonada| s. Arte de caminar sobre madera sin esfuerzo. (Recuérdese que bastonada es una especie de tormento que consiste en golpear con un bastón las plantas de los pies.)
Batalla| s. Método de desatar con los dientes un nudo político que no pudo desatarse con la lengua.
Bautismo| s. Rito sagrado de tal eficacia que aquel que entra en el cielo sin haberlo recibido
Bebé| s. Ser deforme
Beber| v. t. e. i. Echar un trago
Belladona| s. En italiano
Belleza| s. Don femenino que seduce a un amante y aterra a un marido.
Benefactor| s. Dícese del que compra grandes cantidades de ingratitud
Beso| s. Palabra inventada por los poetas para que rime con “embeleso”.Se supone que designa
Bestia| s. Miembro de la dinastía reinante en las letras y la vida. La tribu de los Bestias llegó con Adán
Bigamia| s. Mal gusto que la sabiduría del futuro castigará con la trigamia.
Blanco| adj. Negro.
Boca| s. En el hombre
Boda| s. Ceremonia por la que dos personas se proponen convertirse en una
Bolsillo| s. Cuna de los nativos
Botánica| s. Ciencia de los vegetales
Boticario| s. Cómplice del médico
Brahma| s. Creador de los hindúes
Bruja| s. (1) Mujer fea y repulsiva en perversa alianza con el demonio. (2) Muchacha joven y hermosa
Brujería| s. Antiguo prototipo de la influencia política. Gozaba
Bruto| s. Ver Marido.
Bueno| adj. Sensible
Bufón| s. Antiguamente
Caaba| s. Piedra de gran tamaño ofrecida por el arcángel Gabriel al patriarca Abraham
Cabo| s. Hombre que ocupa el último peldaño de la escalera militar; cuando un cabo cae en combate
Cagatintas| s. Funcionario útil que con frecuencia dirige un periódico. En esta función está estrechamente ligado al chantajista por el vínculo de la ocasional identidad; en realidad el cagatintas no es más que el chantajista bajo otro aspecto
Caimán| s. Cocodrilo de América
Calamidad| s. Recordatorio evidente e inconfundible de que las cosas de esta vida no obedecen a nuestra voluntad. Hay dos clases de calamidades: las desgracias propias y la buena suerte ajena.
Camello| s. Cuadrúpedo (“Palmipes Jorobidorsus”) muy apreciado en el negocio circense. Hay dos clases de camellos: el camello propiamente dicho y el camello impropiamente dicho. Este último es el que siempre se exhibe.
Camino| s. Faja de tierra que permite ir de donde uno está cansado a donde es inútil ir.
Candidatear| s. Someter a alguien al más elevado impuesto político. Proponer una persona adecuada para que sea enlodada y abucheada por la oposición.
Candidato| s. Caballero modesto que renuncia a la distinción de la vida privada y busca afanosamente la honorable oscuridad de la función pública.
Cangrejo| s. Pequeño crustáceo parecido a la langosta
Caníbal| s. Gastrónomo de la vieja escuela
Cáñamo| s. Planta con cuya corteza fibrosa se hacen collares
Cañón| s. Instrumento usado en la rectificación de las fronteras.
Capacidad| s. Conjunto de dotes naturales que permiten realizar una pequeña parte de las ambiciones más mezquinas que distinguen a los hombres capaces de los muertos. En último análisis
Capital| s. Sede del desgobierno. Lo que provee el fuego
Carcaj| s. Vaina portátil en que el antiguo estadista y el abnegado aborigen transportaban su argumento más liviano.
Carnada| s. Preparado que hace más apetitoso el anzuelo. La belleza es la mejor de las carnadas.
Carne| s. Segunda Persona de la Trinidad secular.
Carnívoro| adj. Dícese del que cruelmente acostumbra devorar al tímido vegetariano
Cartesiano| adj. Relativo a Descartes
Casa| s. Estructura hueca construida para habitación del hombre
Castigo| s. Lluvia de fuego y azufre que cae sobre los justos e igualmente sobre los injustos que no se han protegido expulsando a los primeros.
Celo| s. Cierto desorden nervioso que afecta a los jóvenes e inexpertos. Pasión que precede a una prosternación.
Celoso| adj. Indebidamente preocupado por conservar lo que sólo se puede perder cuando no vale la pena conservarlo.
Cementerio| s. Terreno suburbano aislado donde los deudos conciertan mentiras
Cenobita| s. Hombre que piadosamente se encierra para meditar en el pecado; y que para mantenerlo fresco en la memoria
Centauro| s. Miembro de una raza de personas que existió antes que la división del trabajo alcanzara su grado actual de diferenciación
Cerbero| s. El perro guardián del Hades
Cerdo| s. Ave notable por la uníversalidad de su apetito
Cerebro| s. Aparato con que pensamos que pensamos. Lo que distingue al hombre contento
Cerradura| s. Divisa de la civilización y el progreso.
Cetro| s. Bastón de mando de un rey
Cimitarra| s. Espada curva de extremado filo en cuyo manejo ciertos orientales alcanzan extraordinario virtuosismo
Cínico| s. Miserable cuya defectuosa vista le hace ver las cosas como son y no como debieran ser. Los escitas acostumbran arrancar los ojos a los cínicos para mejorarles la visión.
Circo| s. Lugar donde se permite a caballos
Cita| s. Repetición errónea de palabras ajenas.
Clarinete| s. Instrumento de tortura manejado por un ejecutor con algodón en los oídos. Hay instrumentos peores que un clarinete: dos clarinetes.
Cleptómano| s. Ladrón rico.
Clérigo| s. Hombre que se encarga de administrar nuestros negocios espirituales
Clio| s. Una de las Nueve Musas. La función de Clio era presidir la Historia. Lo hizo con gran dignidad. Muchos de los ciudadanos prominentes de Atenas ocuparon asientos en el estrado cuando hablaban los señores Jenofonte
Cobarde| adj. Dícese del que en una emergencia peligrosa piensa con las piernas.
Cociente| s. Número que expresa la cantidad de veces que una suma de dinero perteneciente a una persona está contenida en el bolsillo de la otra; la cifra exacta depende de la capacidad del bolsillo.
Col| s. Legumbre familiar comestible
Cola| s. Parte del espinazo de un animal que ha trascendido sus limitaciones naturales para llevar una existencia independiente en un mundo propio. Salvo en el estado fetal
Comercio| s. Especie de transacción en que A roba a B los bienes de C
Comestible| adj. Dícese de lo que es bueno para comer
Complacer| v. t. Poner los cimientos para una superestructura de imposiciones.
Cómplice| s. El que con pleno conocimiento de causa se asocia al crimen de otro; como un abogado que defiende a un criminal
Comprometido| adj. Provisto de un aro en el tobillo para sujetar la cadena y los grilletes.
Compromiso| s. Arreglo de intereses en conflicto que da a cada adversario la satisfacción de pensar que ha conseguido lo que no debió conseguir
Compulsión| s. La elocuencia del poder.
Condolerse| v.r. Demostrar que el luto es un mal menor que la simpatía.
Conferencista| s. Alguien que le pone a usted la mano en su bolsillo
Confidente| s. Aquél a quien A confía los secretos de B
Confort| s. Estado de ánimo producido por la contemplación de la desgracia ajena.
Congratulaciones| s. Cortesía de la envidia.
Congreso| s. Grupo de hombres que se reúnen para abrogar las leyes.
Conocedor| s. Especialista que sabe todo acerca de algo
Conocido| s. Persona a quien conocemos lo bastante para pedirle dinero prestado
Consejo| s. La más pequeña de las monedas en curso.
Conservador| adj. Dícese del estadista enamorado de los males existentes
Cónsul| s. En política americana
Consultar| v.l. Requerir la aprobación de otro para tomar una actitud ya resuelta.
Controversia| s. Batalla en que la saliva o la tinta reemplazan al insultante cañonazo o la desconsiderada bayoneta.
Convencido| adj. Equivocado a voz en cuello.
Conventillo| s. Fruto de una flor llamada Palacio.
Convento| s. Lugar de retiro para las mujeres que desean tener tiempo libre para meditar sobre el vicio de la pereza.
Conversación| s. Feria donde se exhibe la mercancía mental menuda
Corazón| s. Bomba muscular automática que hace circular la sangre. Figuradamente se dice que este útil órgano es la sede de las emociones y los sentimientos: bonita fantasía que no es más que el resabio de una creencia antaño universal. Sabemos ahora que sentimientos y emociones residen en el estómago y son extraídos de los alimentos mediante la acción química del jugo gástrico. El proceso exacto que convierte el bistec en un sentimiento (tierno o no
Coronación| s. Ceremonia de investir a un soberano con los signos externos y visibles de su derecho divino a ser volado hasta el cielo por una bomba.
Corporación| s. Ingenioso artificio para obtener ganancia individual sin responsabilidad individual.
Corsario| s. Político de los mares.
Costumbre| s. Cadena de los libres.
Cremona| s. Violín de alto precio fabricado en Connecticut.
Cristiano| s. El que cree que el Nuevo Testamento es un libro de inspiración divina que responde admirablemente a las necesidades espirituales de su vecino. El que sigue las enseñanzas de Cristo en la medida que no resulten incompatibles con una vida de pecado.
Crítico| s. Persona que se jacta de lo difícil que es satisfacerlo
Cruz| s. Antiguo símbolo religioso cuya significación se atribuye erróneamente al más solemne acontecimiento en la historia de la Cristiandad
Cuadro| s. Representación en dos dimensiones de un aburrimiento que tiene tres.
Cupido| s. El llamado dios del amor. Esta creación bastarda de una bárbara fantasía fue indudablemente infligida a la mitología para que purgara los pecados de sus dioses. De todas las concepciones desprovistas de belleza y de verdad
Curiosidad| s. Reprensible cualidad de la mente femenina. El deseo de saber si una mujer es
Datario| s. Alto dignatario de la Iglesia Católica Romana
Deber| s. Lo que nos impulsa inflexiblemente en la dirección del lucro
Deber| v. t. Tener (y conservar) una deuda. Antiguamente la palabra no significaba deuda sino posesión; en la mente de muchos deudores existe todavía una gran confusión entre ambas cosas. (En inglés “to owe” (deber
Debilidad| s. Facultad innata de la mujer tiránica que le permite dominar al macho de la especie
Decálogo| s. Serie de diez mandamientos: número suficiente para permitir una selección inteligente de los que se quiere observar.
Decidir| v. t. Sucumbir a la preponderancia de un grupo de influencias sobre otro grupo de influencias.
Defeccionar| v. i. Cambiar bruscamente de opinión y pasarse a otro bando. La defección más notable de que haya constancia es la de Saulo de Tarso
Degenerado| adj. Menos admirable que sus antepasados. Los contemporáneos de Homero eran notables ejemplos de degeneración; hacían falta diez de ellos para alzar una roca o promover un motín que cualquier héroe de la guerra troyana habría alzado o promovido con facilidad.
Degradación| s. Una de las etapas del progreso moral y social que lleva de la humilde condición privada al privilegio político.
Dejeuner| s. El desayuno de un norteamericano que ha estado en París. Hay varias pronunciaciones.
Delegado| s. Pariente de un funcionario. El delegado es
Deliberación| s. Acto de examinar el propio pan para saber de qué lado tiene manteca.
Dentista| s. Prestidigitador que nos pone una clase de metal en la boca y nos saca otra clase de metal del bolsillo.
Dependiente| adj. Dícese del que confía en la generosidad de otro cuando no puede abusar de sus temores.
Derecho| s. Autoridad legítima para ser
Desagravio| s. Reparación sin satisfacción. Entre los anglosajones
Desgracia| s. Enfermedad que se contrae al exponerse a la prosperidad de un amigo.
Desmemoria| s. Don que otorga Dios a los deudores
Desobedecer| s. Celebrar con una ceremonia apropiada la madurez de una orden.
Desobediencia| s. Borde plateado de una nube de servidumbre.
Desposada| s. Mujer que tiene a su espalda una brillante perspectiva de felicidad.
Desprecio| s. Sentimiento que experimenta un hombre prudente ante un enemigo demasiado temible para hacerle frente sin peligro.
Destino| s. Justificación del crimen de un tirano; pretexto del fracaso de un imbécil.
Desvencijado| adj. Perteneciente a cierto orden arquitectónico también llamado Americano Normal. La mayoría de los edificios públicos de los Estados Unidos pertenecen al Orden Desvencijado. Los recientes agregados a la Casa Blanca de Washington pertenecen a Theodórico orden eclesiástica de los dorios… Son muy hermosos y cuestan un centenar de dólares por ladrillo.
Detener| v. t. Arrestar a alguien acusado de conducta insólita. “Dios hizo el mundo en seis días y se detuvo el séptimo” (Versión No Autorizada de la Biblia)
Devoción| s. Reverencia por el Ser Supremo basada en su presunta semejanza con el hombre.
Deuda| s. Ingenioso sustituto de la cadena y el látigo del negrero.
Día| s. Período de veinticuatro horas en su mayor parte desperdiciado. Se divide en el día propiamente dicho y la noche o día impropiamente dicho; el primero se consagra a los pecados financieros y la segunda a los otros pecados. Estas dos clases de actividad social se complementan.
Diafragma| s. Tabique muscular que separa los trastornos del tórax de los trastornos intestinales.
Diagnóstico| s. Pronóstico de enfermedad que realiza el médico tomando el pulso y la bolsa del paciente. ( En inglés hay un juego de palabras: “the patient’s pulse and purse”)
Diamante| s. Mineral que suele encontrarse debajo de un corset. Soluble en solicitato de oro.
Diana| s. Señal que se da a los soldados dormidos para que dejen de soñar con campos de batalla
Diccionario| s. Perverso artificio literario que paraliza el crecimiento de una lengua además de quitarle soltura y elasticidad. El presente diccionario
Dictador| s. Mandatario de un país que prefiere la pestilencia del despotismo a la plaga de la anarquía.
Difamar| v. t. Atribuir maliciosamente a otro vicios que no hemos tenido la oportunidad ni la tentación de practicar.
Difamar| v. t. Decir mentiras sobre otro. Decir verdades sobre otro.
Digestión| s. Conversión de vituallas en virtudes. Cuando el proceso es imperfecto
Diluvio| s. El primero y más notable de los experimentos de bautismo
Dinero| s. Bien que no nos sirve de nada hasta que nos separamos de él. Indicio de cultura y pasaporte para una sociedad elegante. Posesión soportable.
Diplomacia| s. Arte de mentir en nombre del país.
Discriminar| v. t. Señalar los aspectos en que una persona o cosa es
Disculparse| v. i. Sentar las bases para una ofensa futura.
Discusión| s. Método de confirmar a los demás en sus errores.
Disimular| v. t. e i. Poner camisa limpia al carácter.
Distancia| s. Único bien que los ricos permiten conservar a los pobres.
Disuadir| v. t. Proponer a otro un error mucho más grande que el que está por cometer.
Diversión| s. Cualquier clase de entretenimiento cuyas incursiones se detienen
Dolor| s. Estado de ánimo ingrato
Doncella| s. Joven del sexo desagradable
Dragón| s. Soldado que une el arrojo a la calma en proporciones tan iguales
Dramaturgo| s. Dícese del que adapta obras del francés.
Druidas| s. Sacerdotes de una antigua religión céltica
Duelo| s. Ceremonia solemne previa a la reconciliación de dos enemigos. Para cumplirla satisfactoriamente
Economía| s. Compra del barril de whisky que no se necesita por el precio de la vaca que no se tiene.
Educación| s. Lo que revela al sabio y esconde al necio su falta de comprensión.
Ecuanimidad| s. Disposición de soportar ofensas con humilde compostura
Efecto| s. El segundo de dos fenómenos que ocurren siempre en el mismo orden. Se dice que el primero
Egoísta| s. Persona de mal gusto
Egoísta| adj. Sin consideración por el egoísmo de los demás.
Electricidad| s. Fuerza causante de todos los fenómenos naturales a los que no se puede atribuir otra causa. Es la misma cosa que el rayo
Elegía| s. Composición en verso
Elíseo| s. País imaginario y encantador que los antiguos neciamente creían habitado por las almas de los buenos. Esta fábula ridícula y maliciosa fue barrida de la superficie de la tierra por los primeros cristianos: ¡que sus almas sean felices en el Cielo!
Elocuencia| s. Arte oral de persuadir a los tontos de que lo blanco es blanco. Incluye el don de hacer creer que cualquier color es blanco.
Elogio| s. Tributo que pagamos a realizaciones que se parecen a las nuestras sin igualarlas.
Emancipación| s. Cambio por el que un esclavo trueca la tiranía de otro por el propio despotismo.
Embalsamar| v. t. Defraudar a la vegetación
Embuste| s. Mentira que no ha cortado los dientes. La mayor aproximación a la verdad de un mentiroso consuetudinario en el perigeo de su órbita excéntrica.
Emoción| s. Enfermedad postrante causada por el ascenso del corazón a la cabeza. A veces viene acompañada de una copiosa descarga de cloruro de sodio disuelto en agua
Empalamiento| s. Enfermedad postrante causada por el ascenso del arma que permanece fija en la herida. Esto
Empujón| s. Una de las dos cosas que llevan al éxito
Encomio| s. Una clase especial (aunque no particular) de mentira.
Entendimiento| s. Secreción cerebral que permite a quien la posee distinguir una casa de un caballo
Entrañas| s. Estómago
Entusiasmo| s. Dolencia de la juventud
Envidia| s. Emulación adaptada a la capacidad más ruin.
Epicúreo| s. Adversario de Epicuro
Epitafio| s. Inscripción que
Ermitaño| s. Persona cuyos vicios y locuras no se ejercen en sociedad.
Escarabajo| s. Insecto sagrado de los antiguos egipcios. Presuntamente simbolizaba la inmortalidad y el hecho de que sólo Dios supiera por qué
Escarificación| s. Forma de penitencia practicada por los devotos medievales. El rito se efectuaba a veces con un cuchillo
Escriba| s. Escritor profesional de opiniones antagónicas a las nuestras.
Escrituras| s. Los sagrados libros de nuestra santa religión
Espalda| s. Parte del cuerpo de un amigo que uno tiene el privilegio de contemplar en la adversidad.
Espejo| s. Plano vítreo sobre el que aparece un efímero espectáculo dado para desilusión del hombre. El rey de Manchuria tenía un espejo mágico
Espiar| v. i. Escuchar secretamente un catálogo de los crímenes y vicios de otro
Erudición| s. Polvillo que cae de un libro a un cráneo vacío.
Esotérico| adj. Abstruso en forma muy particular
Eterno| adj. Dícese de lo que dura para siempre. Es con mucha timidez que me atrevo a ofrecer esa breve y elemental definición
Etnología| s. Ciencia que estudia las distintas tribus del Hombre: por ejemplo
Eucaristía| s. Fiesta sagrada de la secta religiosa de los Teófagos. En esta secta surgió una vez una infortunada disputa acerca de lo que comían. Dicha controversia ha causado ya la muerte a quinientas mil personas
Evangelista| s. Portador de buenas nuevas
Excentricidad| s. Método de distinción tan vulgar que los tontos lo usan para acentuar su incapacidad.
Excepción| s. Cosa que se toma la libertad de diferir de las otras cosas de su clase
Exceso| s. En moral
Exhortar| v. t. En materia religiosa
Exiliado| s. El que sirve a su país viviendo en el extranjero
Éxito| s. El único pecado imperdonable contra nuestros semejantes.
Experiencia| s. Sabiduría que nos permite reconocer como una vieja e indeseable amistad a la locura que ya cometimos.
Expulsión| s. Remedio eficaz para la enfermedad de la charlatanería. Muy usado también en casos de extrema pobreza.
Extinción| s. Materia prima con que la teología creó el estado futuro.
Extremidad| s. Rama de un árbol o pierna de una mujer norteamericana.
Extremo| s. La posición más alejada
Famoso| adj. Notoriamente miserable.
Fanático| adj. Dícese del que obstinada y ardorosamente sostiene una opinión que no es la nuestra.
Fantasma| s. Signo exterior e invisible de un temor inferior. Para explicar el comportamiento inusitado de los fantasmas
Faro| s. Edificio elevado sobre una playa
Favor| s. Breve prólogo a diez volúmenes de exacción.
Fe| s. Creencia sin pruebas en lo que alguien nos dice sin fundamento sobre cosas sin paralelo.
Fealdad| s. Don de los dioses a ciertas mujeres que pueden ser virtuosas sin ser humildes.
Felicidad| s. Sensación agradable que nace de contemplar la miseria ajena.
Felón| s. Persona de más empuje que discreción
Ferrocarril| s. El principal entre los medios mecánicos que nos permiten alejarnos de donde estamos hacia donde no estaremos mejor.. El optimista lo prefiere por su rapidez.
Fiador| s. Tonto que poseyendo bienes propios se hace responsable de los que otro confía a un tercero. Felipe de Orleans
Fidelidad| s. Virtud que caracteriza a los que están por ser traicionados.
Fiesta| s. Celebración religiosa generalmente caracterizada por la glotonería y la ebriedad
Filántropo| s. Anciano caballero
Filibustero| s. Pirata de poco bordo
Filisteo| s. Aquel cuya mente es producto de su medio
Filosofía| s. Camino de muchos ramales que conduce de ninguna parte a la nada.
Finanzas| s. Arte o ciencia de administrar ingresos y recursos para la mayor conveniencia del administrador.
Fisonomía| s. Arte de determinar el carácter de otro por las semejanzas y diferencias entre su rostro y el nuestro
Folletín| s. Obra literaria
Folklore| s. Sabiduría popular que abarca mitos y supersticiones. En la obra de Baring Gould
Fonógrafo| s. Juguete irritante que devuelve la vida a ruidos muertos. Forma pauperis
Fotografía| s. Cuadro pintado por el sol sin previo aprendizaje del arte. Es algo mejor que el trabajo de un apache
Frenología| s. Ciencia de alivianar el bolsillo a través del cráneo. Consiste en localizar y explotar el órgano con que uno es un tonto.
Frontera| s. En Geografía política
Funeral| s. Ceremonia mediante la que demostramos nuestro respeto por los muertos enriqueciendo al sepulturero
Futuro| s. Época en que nuestros asuntos prosperan
Ganso| s. Ave que suministra plumas para escribir que
Gárgola| s. Desagüe saledizo en los tejados de los edificios medievales
Gato| s. Autómata blando e indestructible que nos da la naturaleza para que lo pateemos cuando las cosas andan mal en el círculo doméstico.
Genealogía| s. Estudio de nuestra filiación hasta llegar a un antepasado que no tuvo interés en averiguar la suya.
Generoso| adj. Originariamente
Geógrafo| s. Sujeto que puede explicarnos de primera intención la diferencia entre lo que está fuera del mundo y lo que está adentro.
Geología| s. Ciencia de la corteza terrestre
Glotón| s. Persona que escapa a los riesgos de la moderación incurriendo en dispepsia.
Gnóstico| s. Miembro de una secta de filósofos que tratan de fusionar a los primitivos cristianos con los platónicos. Los primeros no quisieron entrar en conversaciones
Gnu| s. Animal sudafricano
Gota| s. Nombre que da el médico al reumatismo de un paciente rico.
Gracias| s. Tres bellas diosas
Gramática| s. Sistema de trampas cuidadosamente preparadas en el camino por donde el autodidacto avanza hacia la distinción.
Gravitación| s. Tendencia de todos los cuerpos a acercarse unos a otros con fuerza proporcional a la cantidad de materia que contienen; la cantidad de materia que contienen se determina por la tendencia a acercarse unos a otros. Bello y edificante ejemplo de cómo la ciencia
Guillotina| s. Máquina que hace que un francés se encoja de hombros con buen motivo. En su gran obra sobre “Líneas Divergentes de la Evolución Racial”
Hablar| v. i. Ser indiscreto sin ser tentado
Hada| s. Ser de formas diversas y variados dones que habitaba antiguamente los prados y los bosques. Tenía hábitos nocturnos y era afecta a la danza y al robo de niños. Los naturalistas sostienen que las hadas se han extinguido en la actualidad
Hades| s. El mundo interior; residencia de los espíritus difuntos; lugar donde viven los muertos. Entre los antiguos
Halo| s. En sentido lato
Harmonistas| s. Secta de protestantes
Hibernar| v. i. Pasar el invierno en reclusión doméstica. Las creencias populares sobre la hibernación de distintos animales son numerosas y raras. Muchos creen que el oso hiberna todo el invierno y subsiste lamiéndose mecánicamente las zarpas. Se admite que en la primavera sale de su retiro
Híbrido| s. Diferencia conciliada.
Hidra| s. Animal que en los antiguos catálogos figura bajo muchos encabezamientos.
Hiena| s. Bestia reverenciada por algunos pueblos orientales
Hígado| s. Órgano rojo
Hilo| s. Tela cuya fabricación
Hipogrifo| s. Animal
Hipócrita| s. El que profesando virtudes que no respeta se asegura la ventaja de parecer lo que desprecia.
Historia| s. Relato casi siempre falso de hechos casi siempre nimios producidos por gobernantes casi siempre pillos o por militares casi siempre necios.
Historiador| s. Chismoso de trocha ancha.
Hogar| amargo hogar.
Hombre| s. Animal tan sumergido en la extática contemplación de lo que cree ser
Homeópata| s. Humorista de la medicina.
Homeopatía| s. Escuela de medicina que está a mitad de camino entre la alopatía y la Ciencia Cristiana. Esta última es muy superior a todas las otras
Homicidio| s. Muerte de un ser humano por otro ser humano.
Honorable| adj. Dícese de lo que está afligido por un impedimento en su capacidad general. En las cámaras legislativas se acostumbra dar el título de “honorable” a todos los miembros. V.g.: “El honorable diputado es un perro sarnoso”.
Hospitalidad| s. Virtud que nos induce a alojar y alimentar a personas que no necesitan alojamiento ni alimento.
Hostilidad| s. Sentimiento exacerbado de la superpoblación terrestre. Puede ser activa o pasiva. Es activa
Huérfano| s. Persona a quien la muerte ha privado de la posibilidad de ingratitud filial
Humanidad| s. La raza humana
Humildad| s. Paciencia inusitada para planear una venganza que valga la pena.
Humillación| s. Actitud mental decente y habitual en presencia del dinero o el poder. Peculiarmente apropiada en un empleado cuando se dirige a su patrón.
Humorista| s. Plaga que habría ablandado la gélida rudeza de corazón del Faraón
Huracán| s. Manifestación atmosférica antes muy común
Hurí| s. Atractiva señora que habita el paraíso mahometano
Idiota| s. Miembro de una vasta y poderosa tribu cuya influencia en los asuntos humanos ha sido siempre dominante. La actividad del Idiota no se limita a ningún campo especial de pensamiento o acción
Ignorante| s. Persona desprovista de ciertos conocimientos que usted posee
Ilusión| s. Madre de una respetabilísima familia
Ilustre| adj. Favorablemente situado para recibir las flechas de la malicia
Imaginación| s. Depósito de mercaderías que poseen en común los poetas y los mentirosos.
Imbecilidad| s. Especie de inspiración divina o fuego sagrado que anima a los detractores de este diccionario.
Imparcial| adj. Incapaz de percibir promesa de ventaja personal en la adhesión a uno de los bandos de una controversia
Impenitencia| s. Estado de ánimo intermedio
Impiedad| s. Irreverencia del prójimo hacia mis dioses.
Imposición| s. Acto de bendecir o consagrar imponiendo las manos: ceremonia común a muchos sistemas eclesiásticos
Impostor| s. Rival que también aspira a los honores públicos.
Imprevisión| s. Satisfacción de las necesidades de hoy con las rentas de mañana.
Impunidad| s. Riqueza.
Inadmisible| adj. Que no merece ser considerado. Dícese de ciertos testimonios que los jurados son incapaces de apreciar
Inauspiciosamente| adv. De manera poco promisoria
Incompatibilidad| s. En el matrimonio
Incompatible| adj. Incapaz de existir en presencia de otra cosa. Dos cosas son incompatibles cuando el mundo del ser tiene espacio suficiente para una
Inconducta| s. Infracción de la ley que posee menos dignidad que la felonía y no autoriza el ingreso en la mejor sociedad criminal.
Incubo| s. Miembro de una raza de demonios extraordinariamente impúdicos que
Indice| s. Dedo que se usa generalmente para señalar a los malechores.
Indecisión| s. Factor principal del éxito
Indefenso| adj. Incapaz de atacar.
Independiente| adj. En política
Indigestión| s. Enfermedad que el paciente y sus amigos suelen tomar por profunda convicción religiosa e interés en la salvación de la humanidad. Como dijo el sencillo Piel Roja del desierto: “Yo bien no reza; gran dolor barriga
Indiscreción| s. Culpa de las mujeres.
Indultar| v. t. Remitir una pena y devolver al acusado a una vida criminal. Agregar a la fascinación del crimen la tentación de la ingratitud.
Ineficaz| adj. Dícese de lo que no está calculado para favorecer nuestros intereses.
Infiel| adj. y s. Dícese
Infralapsario| s. El que se atreve a creer que Adán no tenía necesidad de pecar
Injusticia| s. De todas las cargas que soportamos o imponemos a los demás
Inferiae| s (latín). Entre los griegos y los romanos
Influencia| s. En política
Infortunio| s. Especie de fortuna que siempre llega.
Ingenio| s. Sal con que el humorista americano arruina su cocina intelectual
Ingenuidad| s. Seductora cualidad que alcanzan las mujeres mediante largo estudio e intensa práctica con sus admiradores varones
Ingrato| s. El que recibe un beneficio de otro
Injuria| s. Ofensa que sigue en gravedad a un desdén.
Inmigrante| s. Persona inculta que piensa que un país es mejor que otro.
Inmoral| adj. Impráctico. Todo lo que resulta poco práctico para los hombres
Innato| adj. Natural
Inscripción| s. Una cosa escrita sobre otra cosa. Hay muchas clases de inscripciones
Insensible| adj. Dotado de gran fortaleza para soportar los males que aquejan a los demás. Cuando le dijeron a Zenón que uno de sus enemigos había muerto
Insignias| s. Distintivos
Insurrección| s. Revolución fallida. Fracaso de opositores que pretenden reemplazar un gobierno malo por otro desastroso.
Intemperie| s. Lugar donde ningún gobierno ha podido cobrar impuestos. Su función principal es inspirar a los poetas.
Intención| s. Conciencia del predominio que un grupo de influencias ejerce en nuestro espíritu sobre otro grupo de influencias. Efecto cuya causa es la inminencia
Intérprete| s. El que permite a dos personas de distinto idioma comprenderse
Interregno| s. Período durante el cual una monarquía es gobernada por un lugar aún tibio en el almohadón de un trono. La experiencia de permitir que ese lugar se enfríe ha dado generalmente malos resultados
Intimidad| s. Relación a que son providencialmente arrastrados los necios a fin de destruirse.
Inventor| s. Persona que construye un ingenioso ordenamiento de ruedas
Ira| s. Enojo de grado y cualidad superiores que corresponde a personajes encumbrados y a ocasiones importantes: como “la ira de Dios”
Irreligión| s. La más importante entre las grandes creencias de este mundo.
Jábega| s. Red barredera. Para atrapar peces se hace con una malla gruesa y ruda; las mujeres se atrapan más fácilmente mediante un tejido singularmente delicado que lleva
Jineta| s. En el ejército
Juramento| s. En derecho
Justicia| s. Artículo más o menos adulterado que el Estado vende al ciudadano a cambio de su lealtad
Juventud| s. Período de lo Posible
Kilt| s. Traje que suelen usar los escoceses en Norteamérica y los norteamericanos en Escocia.
Korán| s. Libro que los mahometanos
Ladrón| s. Comerciante candoroso. Se cuenta de Voltaire que una noche se alojó
Lamentable| adj. Estado de un enemigo o adversario después de un encuentro imaginario con uno mismo.
Laocoonte| s. Famosa escultura antigua que representa a un sacerdote de ese nombre y a sus dos hijos entre los anillos de dos monstruosas serpientes. El arte y diligencia con que el anciano y sus muchachos sostienen a las serpientes y las obligan a realizar su tarea constituyen una de las más nobles ilustraciones artísticas del dominio de la inteligencia humana sobre la inercia bruta.
Lástima| s. Sensación de inmunidad
Legal| adj. Compatible con la voluntad del juez competente.
Lenguaje| s. Música con que encantamos las serpientes que custodian el tesoro ajeno.
Lexicógrafo| s. Individuo pestilente que so pretexto de registrar un determinado estadio en el desarrollo de una lengua
Libertad| s. Uno de los bienes más preciosos de la Imaginación
Libertino| s. El que ha corrido tras el placer con tanto ardor
Ligas| s. Bandas elásticas destinadas a impedir que una mujer salga de sus medias y devaste el país.
Lío| s. Salario de la coherencia.
Lira| s. Antiguo instrumento de tortura. Hoy la palabra se usa figuradamente con el sentido de facultad poética.
Litigante| s. Persona que está por entregar la piel con la esperanza de conservar los huesos.
Lobisón| s. Lobo que fue una vez
Loco| adj. Dícese de quien está afectado de un alto nivel de independencia intelectual; del que no se conforma a las normas de pensamiento
Locuacidad| s. Dolencia que vuelve al paciente incapaz de contener la lengua cuando uno quiere hablar.
Locura| s. Ese “don y divina facultad” cuya energía creadora y ordenadora inspira el espíritu del hombre
Locomaquia| s. Guerra en que las armas son palabras y las heridas
Longevidad| s. Prolongación poco común del temor a la muerte.
Lord| s. En la sociedad norteamericana
Luminaria| s. El que arroja luz sobre un tema; verbigracia
Lunario| s. Habitante de la luna. No debe confundirse con el lunático
Lunes| s. En los países cristianos
Lógica| s. Arte de pensar y razonar en estricta concordancia con los límites e incapacidades de la incomprensión humana. La base lógica es el silogismo
Macho| s. Miembro del sexo insignificante. El macho de la especie humana es generalmente conocido (por la mujer) como Simple Hombre. El género tiene dos variedades: buenos proveedores y malos proveedores.
Macrobiano| s. Olvidado de los dioses que alcanza una edad muy avanzada. La historia nos da numerosos ejemplos
Magia| s. Arte de convertir la superstición en moneda contante y sonante. Hay otras artes que sirven al mismo fin
Magnético| adj. Dícese de lo que sufre la influencia del magnetismo.
Magnetismo| s. Lo que ejerce influencia sobre algo magnético. Estas dos definiciones están condensadas de la obra de un millar de eminentes hombres de ciencia
Magnífico| adj. Dotado de esplendor o grandeza superiores a los que el espectador está habituado; por ejemplo
Magnitud| s. Tamaño. Como la magnitud es puramente relativa
Majestad| s. Condición y titulo de rey
Malechor| s. El principal factor en el progreso de la raza humana.
Malthusiano| adj. Relativo a Malthus y sus doctrinas. Malthus creía en la necesidad de limitar artificialmente la población
Mamíferos| s. Familia de vertebrados cuyas hembras
Mamón| s. Dios de la religión que predomina en el mundo. Su templo principal se halla en la santa ciudad de Nueva York.
Maná| s. Alimento dado milagrosamente a los israelitas en el desierto. Cuando no lo recibieron más
Maniqueísmo| s. Antigua doctrina persa según la cual hay guerra incesante entre el Bien y el Mal. Cuando el Bien abandonó la lucha
Mano| s. Instrumento singular que se usa al extremo de un brazo humano
Maquinación| s. Método empleado por nuestros enemigos para anular nuestro declarado y honroso esfuerzo por hacer lo justo.
Marido| s. El que después de cenar debe encargarse de lavar el plato.
Mártir| s. Alguien que avanza hacia una muerte deseada siguiendo el camino de la menor repugnancia.
Más| adj. Grado comparativo de demasiado.
Masonería| s. Orden de ritual secreto
Matar| v. t. Crear una vacante sin designar un sucesor.
Matrimonio| s. Condición o estado de una comunidad formada por un amo
Mausoleo| s. La última y más divertida locura de los ricos.
Mayonesa| s. Uno de los aderezos que usan los franceses en lugar de la religión del estado.
Maza| s. Bastón que en la función pública denota autoridad. Su forma
Meandro| s. Curva sinuosa. Toma su nombre de un río situado unas ciento cincuenta millas al sur de Troya
Medalla| s. Pequeño disco de metal que se da en premio de virtudes
Médico| s. Alguien a quien lanzamos nuestras súplicas cuando estamos enfermos
Mendaz| adj. Aficionado a la retórica.
Mendigar| v. t. Pedir algo con intensidad proporcional a la creencia de que no será otorgado.
Mendigo| s. El que ha confiado en la ayuda de los amigos.
Menor| adj. Menos objetable.
Mente| s. Misteriosa forma de la materia segregada por el cerebro. Su principal actividad parece consistir en el esfuerzo por determinar su propia naturaleza
Metralla| s. Argumento que el futuro prepara en respuesta a las demandas del socialismo americano.
Metrópoli| s. Baluarte del provincialismo.
Mesmerismo| s. Nombre dado al Hipnotismo antes que empezara a vestir con elegancia
Mi| n. Caso objetable del pronombre personal de primera persona
Milagro| s. Acontecimiento inexplicable y extraño al orden natural
Milenio| s. Feriado de mil años a cuyo término se clavará la tapa
Ministro| s. Agente de un poder superior con una responsabilidad inferior. En diplomacia
Mío| adj. Lo que me pertenece
Misericordia| s. Daga que en la guerra medieval usaba el infante para recordar a un caballero desmontado por su cabalgadura que él también era mortal.
Misericordia| s. Virtud que aman los delincuentes sorprendidos.
Miss| s. Título con que marcamos a las mujeres solteras para indicar que están disponibles en el mercado. Miss
Mitad| s. Una de las dos partes en que una cosa puede dividirse o considerarse dividida. En el siglo XIV teólogos y filósofos discutieron acaloradamente si la Omnisciencia podía partir un objeto en tres mitades; y el piadoso padre Aldrovinus rogó públicamente en la catedral de Rouen porque Dios demostrara la afirmativa de la proposición en alguna forma notable e inconfundible (preferiblemente
Mitología| s. Conjunto de creencias de un pueblo primitivo relativas a su origen
Moda| s. Déspota a quien los sabios ridiculizan y obedecen.
Mojigata| s. Celestina que se oculta a espaldas de su conducta.
Molécula| s. Ultima e indivisible unidad de la materia. Se distingue del corpúsculo
Momia| s. Egipcio antiguo
Mónada| s. Ultima e indivisible unidad de la materia (ver Molécula). Según Leibniz
Monarca| s. Persona que se ocupa de reinar. Antiguamente el monarca era el único amo
Mono| s. Animal arbóreo que se instala en los árboles genealógicos.
Monosilábico| adj. Dícese del idioma compuesto de palabras de una sola sílaba
Monseñor| s. Alto título eclesiástico
Monumento| s. Estructura destinada a conmemorar algo que no necesita conmemoración o no puede ser conmemorado. Como dijo el poeta. “Los huesos de Agamenón son ofrecidos en espectáculo
Muerto| adj. Dícese de lo que ha concluido el trabajo de respirar; de lo que ha acabado para todo el mundo; de lo que ha llevado hasta el fin una enloquecida carrera; y de lo que al alcanzar la meta de oro
Mujer| s. Animal que suele vivir en la vecindad del Hombre
Mulato| s. Hijo de dos razas
Multitud| s. Muchedumbre. Fuente de sabiduría y virtud políticas. En una república
Murmurar| v. t. Decir cómo encuentra uno a otro cuando el otro no puede encontrarlo a uno.
Mustang| s. Caballo indócil de las planicies occidentales. En la sociedad británica
Nacimiento| s. Primero y más terrible de todos los desastres. Sobre su naturaleza
Nariz| s. Ultimo puesto avanzado de la cara. Getius
Néctar| s. Bebida que consumían los dioses en los banquetes olímpicos. El secreto de su preparación se ha perdido
Negativa| s. Acción de no dar lo que se pide; verbigracia
Negro| s. “Piece de résistance” en el problema político norteamericano. Los republicanos lo representan por la letra n y llegan a la siguiente ecuación: “Supongamos que n = hombre blanco”. La fórmula
Nepotismo| s. Práctica que consiste en designar a la propia abuela para un cargo público
Newtoniano| adj. Perteneciente a la filosofía del universo inventada por Newton
Nihilista| s. Ruso que niega la existencia de todo
Niñez| s. Período de la vida humana intermedio entre la idiotez de la primera infancia y la locura de la juventud
Nirvana| s. En la religión budista
Noble| s. Invención provista por la naturaleza para que las doncellas norteamericanas adineradas y ambiciosas puedan incurrir en distinción social y padecer la “high life”.
Notoriedad| s. Fama de nuestro adversario en la lucha por un cargo público. El tipo de renombre más accesible y aceptable para la mediocridad. Escala de jacob que conduce a un escenario de vodevil
Noúmeno| s. Lo que existe
Novela| s. (En inglés
Noviembre| s. Décimoprimer duodécimo del tedio.
Observatorio| s. Lugar donde los astrónomos disuelven en conjeturas las adivinanzas de sus predecesores.
Obsoleto| adj. Lo que ya no usan los tímidos. Se aplica principalmente a las palabras. La palabra que cualquier diccionario califica como obsoleta se convierte en objeto de terror para el escritor necio
Obstinado| adj. Inaccesible a la verdad
Ocasional| adj. Dícese de lo que nos aflige con mayor o menor frecuencia. No es el caso de los “versos ocasionales”
Occidente| s. Parte del mundo situada al oeste (o al este) de Oriente. Está habitada principalmente por Cristianos
Océano| s. Extensión acuática que ocupa dos tercios del mundo hecho para el hombre
Ociosidad| s. Granja modelo donde el diablo experimenta las semillas de nuevos pecados y promueve el crecimiento de los vicios básicos.
Odio| s. Sentimiento cuya intensidad es proporcional a la superioridad que lo provoca.
Oleaginoso| adj. Aceitoso
Olímpico| adj. Relativo a una montaña de Tesalia
Olvido| s. Estado en que los malos cesan de luchar y los tristes reposan. Eterno basurero de la fama. Cámara fría de las más altas esperanzas.. Lugar donde los autores ambiciosos reencuentran sus obras sin orgullo
Ópera| s. Espectáculo que representa la vida en otro mundo cuyos habitantes no tienen más idioma que el canto
Opio| s. Puerta que no está cerrada con llave en la prisión de la Identidad. Conduce al patio de la cárcel.
Oponer| v. Ayudar con obstrucciones y objeciones.
Oportunidad| s. Ocasión favorable para atrapar un desengaño.
Optimismo| s. Doctrina o creencia de que todo es hermoso
Optimista| s. Partidario de la doctrina de que lo negro es blanco. En cierta oportunidad un pesimista pidió auxilio a Dios. Ah –dijo Dios–
Oratoria| s. Conspiración entre el lenguaje y la acción para defraudar al entendimiento. Tiranía atenuada por la taquigrafía.
Ordenado| adj. Sujeto al orden
Ostra| s. Molusco viscoso que los hombres civilizados tienen la audacia de comer sin quitarle las entrañas. Las valvas suelen darse a los pobres.
Paciencia| s. Forma menor de la desesperación
Pagano| s. Ser descarriado que incurre en la locura de adorar lo que puede ver y sentir.
Palacio| s. Residencia bella y costosa
Palma| s. Arbol. Una de sus variedades más difundidas y más asiduamente cultivadas es la “palma pruriginosa” (Palma hominis). Este noble vegetal exuda una especie de goma invisible
Pandemonium| s. Literalmente
Panegírico| s. Elogio de una persona que tiene las ventajas del dinero o del poder; o que ha tenido la deferencia de morirse.
Pantalón| s. Prenda que cubre la parte inferior del adulto civilizado de sexo masculino. Es de forma tubular y no posee goznes en los puntos de flexión. Se supone que fue inventado por un humorista.
Panteísmo| s. La doctrina de que todo es Dios
Pantomima| s. Representación teatral en que se narra una historia sin hacer violencia al lenguaje. Es la forma menos desagradable de acción dramática.
Pañuelo| s. Pequeño cuadrado de seda o de hilo
Paraíso| s. Lugar donde los malvados cesan de perturbarnos hablando de sus asuntos personales
Pasado| s. Pequeña fracción de la eternidad de la que tenemos un leve y lamentable conocimiento. Una línea móvil llamada Presente lo separa de un período imaginario llamado Futuro. Estas dos grandes porciones de la Eternidad una de las cuales borra continuamente a la otra
Pasaporte| s. Documento que se inflige traidoramente a un ciudadano que sale de su país
Pasatiempo| s. Artificio para la representación de “misterios” en que el principal actor es trasladado al cielo. En los Estados Unidos
Patriota| s. El que considera superiores los intereses de la parte a los intereses del todo. Juguete de políticos e instrumento de conquistadores.
Patriotismo| s. Basura combustible dispuesta a arder para iluminar el nombre de cualquier ambicioso. En el famoso diccionario del doctor Johnson
Pavo| s. Ave de gran tamaño cuya carne
Paz| s. En política internacional
Peatón| s. Para un automóvil
Pedigré| s. Parte conocida del camino que conduce de un antepasado arbóreo con una vejiga natatoria
Peligro| s. Bestia salvaje que el hombre desprecia cuando está dormida
Pérdida| s. Privación de lo que teníamos
Peregrino| s. Viajero a quien se toma en serio. Padre Peregrino: aquél que abandonó Europa en 1620 porque no lo dejaban cantar salmos con la nariz
Pereza| s. Injustificada dignidad de modales en una persona de baja categoría.
Perfección| s. Estado o cualidad imaginarios que se distinguen de lo real por un elemento llamado excelencia. Atributo de los críticos. El director de una revista inglesa recibió una carta que criticaba sus opiniones y su estilo
Peripatético| adj. Que camina de aquí para allá. Relativo a la filosofía de Aristóteles quien
Perogrullada| s. Elemento fundamental y gloria insigne de la literatura popular. Un pensamiento que ronca en palabras que humean. Sabiduría de un millón de necios en boca de un tonto. Sentimiento fósil en roca artificial. Moraleja sin fábula. Todo lo que es mortal de una verdad fenecida. Pocillo de moralina y leche. Rabadilla de un pavo real desplumado. Medusa que se marchita al borde del mar del pensamiento.Cacareo que sobrevive al huevo. Epigrama desecado.
Perorata| s. Explosión de un cohete oratorio. Encandila
Perro| s. Especie de Divinidad adicional o suplementaria
Perseverancia| s. Virtud interior que permite al mediocre alcanzar un éxito sin gloria.
Pesimismo| s. Filosofía impuesta al observador por el desalentador predominio del optimista
Piano| s. Utensilio de salón para domar al visitante impenitente.
Picota| s. Artificio mecánico para infligir distinción personal
Pillo| s. Tonto considerado bajo otro aspecto. Hombre cuyas cualidades
Pintura| s. Arte de proteger de la intemperie superficies planas
Piratería| s. Comercio sin los pañales de la fantasía
Pirronismo| s. Antigua filosofía
Placer| s. La forma menos detestable del tedio.
Plaga| s. En la antigüedad
Plagiar| s. Asumir el pensamiento o el estilo de otro escritor
Plagio| s. Coincidencia literaria entre una prioridad carente de mérito y una posterioridad honorable.
Planear| v t. Preocuparse por el mejor método de conseguir un resultado casual.
Platónico| adj. Relativo a la filosofía de Sócrates. Amor platónico es el nombre que dan los tontos al afecto entre una incapacidad y una helada.
Plebeyo| s. Romano antiguo que en la sangre de su país no manchaba nada más que las manos. A diferencia del patricio
Plebiscito| s. Votación popular para establecer la voluntad del amo.
Pleito| s. Máquina en la que se entra en forma de cerdo y se sale en forma de salchicha.
Plenipotenciario| adj. Provisto de plenos poderes. Un ministro plenipotenciario es un diplomático a quien se otorga absoluta autoridad con la condición de que nunca la ejerza.
Pleonasmo| s. Ejército de palabras que escolta a un sargento de pensamiento.
Plomo| s. Metal pesado
Pluma| s. Implemento de tortura producido por un ganso
Pobreza| s. Lima para que claven los dientes las ratas de la reforma. El número de planes para abolirla iguala al de reformadores que la padecen más el de filósofos que la ignoran. Sus víctimas se distinguen por la posesión de todas las virtudes
Policía| s. Fuerza armada destinada a asegurar la protección al expolio.
Poligamia| s. Capilla de expiación provista de varios reclinatorios penitenciales
Política| s. Conflicto de intereses disfrazados de lucha de principios. Manejo de los intereses públicos en provecho privado.
Político| s. Anguila en el fango primigenio sobre el que se erige la superestructura de la sociedad organizada. Cuando agita la cola
Pólvora| s. Medio que emplean las naciones civilizadas para arreglar disputas que podrían volverse molestas si no se las resolviera. La mayoría de los autores atribuyen la invención de la pólvora a los chinos
Populista| s. Patriota fósil del primitivo período agrícola
Portátil| adj. Expuesto a propiedad mutable merced a vicisitudes de la posesión.
Portugueses| s. Especie de gansos nativos de Portugal. Prácticamente carecen de plumas y no son muy comestibles
Poseso| adj. Trastornado por un espíritu maligno
Positivismo| s. Filosofía que niega nuestro conocimiento de lo Real y afirma nuestra ignorancia de lo Aparente. Su exponente más largo es Comte; el más ancho
Posteridad| s. Tribunal de apelaciones que anula el juicio de los contemporáneos de un autor popular
Potable| s. Apto para beber. Se dice que el agua es potable
Preadánico| s. Miembro de una raza experimental y aparentemente insatisfactoria que precedió a la Creación y vivió en condiciones difíciles de concebir. Melsius cree que habitaban el “Vacío” y que estuvieron a mitad de camino entre los peces y las aves. Poco se sabe de ellos salvo que proveyeron a Caín de una esposa y a los teólogos de una controversia.
Precedente| s. En jurisprudencia decisión
Precio| s. Valor más una suma razonable por el desgaste que sufre la conciencia al exigirlo.
Precipitación| s. Prisa de los torpes.
Predestinación| s. Doctrina de que todo ocurre según un programa. No debe confundirse con la doctrina de la predeterminación que dice que todas las cosas están programadas pero no afirma que ocurran
Predeterminación| s. Esta palabra parece fácil de definir
Predilección| s. Etapa preparatoria del desengaño.
Preexistencia| s. Factor no tenido en cuenta en la creación.
Preferencia| s. Sentimiento o estado de ánimo inducido por la creencia errónea de que una cosa es mejor que otra.
Prehistórico| adj. Perteneciente a un período primitivo y a un museo. Anterior al arte y práctica de perpetuar falsedades.
Prejuicio| s. Opinión vagabunda sin medios visibles de sostén.
Prelado| s. Dignatario eclesiástico dotado de un grado superior de santidad y de un gordo estipendio. Miembro de la aristocracia celestial. Caballero de Dios.
Prerrogativa| s. Derecho de un soberano a obrar mal.
Presagio| s. Señal de que algo ocurrirá si no ocurre nada.
Presbiteriano| s. Alguien convencido de que todas las autoridades de la Iglesia deberían llamarse presbíteros.
Presentable| s. Abominablemente ataviado según la moda del lugar y la época. En Boorioboola Gha un hombre está presentable en ocasiones de gala si lleva el abdomen pintado de azul brillante y usa una cola de vaca; en Nueva York puede
Presentación| s. Ceremonia social inventada por el demonio para gratificar a sus siervos y atormentar a sus enemigos. La presentación alcanza su desarrollo más perverso en los Estados Unidos y
Presente| s. Parte de la eternidad que separa el dominio del desengaño del reino de la esperanza.
Presidente| s. Cerdo engrasado en los juegos al aire libre de la política norteamericana.
Presidente| s. Figura dominante en un grupito de hombres que son los únicos de los que se sabe con certeza que la inmensa mayoría de sus compatriotas no deseaban que llegaran a la presidencia.
Prevaricador| s. Mentiroso en estado de crisálida.
Primado| s. Cabeza de una Iglesia
Prisión| s. Lugar de castigos y recompensas. El poeta nos asegura que: “No los muros de piedra hacen prisiones”
Privativo| adj. En lenguaje forense dícese de la propiedad individual de tierras
Proboscis| s. Organo rudimentario que usa un elefante en lugar del tenedor y el cuchillo que la Evolución sigue negándole. Con fines humorísticos se le llama popularmente trompa.
Procaz| adj. Dícese del lenguaje que usan otros para criticarnos.
Proceso| s. Investigación formal destinada a probar y consignar por escrito el carácter intachable de jueces
Profecía| s. Arte y práctica de vender nuestra credibilidad con entrega diferida.
Prójimo| s. Aquél a quien no está ordenado amar como a nosotros mismos
Propiedad| s. Cualquier cosa material
Providencial| adj. Dícese de lo que es notoria e inesperadamente beneficioso para quien lo describe.
Prórroga| s. Suspensión de hostilidades contra un asesino sentenciado
Proyectil| s. Ultimo árbitro de las disputas internacionales. Antes esas disputas se resolvían mediante el contacto físico de los contendores
Prueba| s. Evidencia que tiene un matiz más de plausibilidad que de inverosimilitud. Testimonio de dos testigos creíbles
Publicar| v. i. En asuntos literarios
Puerco| s. Animal (Porcus Omnívorus) estrechamente emparentado con la raza humana por el esplendor y vivacidad de su apetito
Puerto| s. Lugar donde los barcos que escapan a la ira de las tormentas quedan expuestos a la furia de los aduaneros.
Quiromancia| s. Método número 947 (según la clasificación de Mibleshaw) de obtener dinero con engaños. Consiste en “leer el carácter” en las líneas de las manos. El carácter puede realmente leerse de este modo
Quórum| s. En un cuerpo deliberativo
Rabdomante| s. El que con una varita adivinatoria busca metales preciosos en el bolsillo de un tonto.
Racional| adj. Desprovisto de ilusiones
Radicalismo| s. El conservadorismo de mañana inyectado en los negocios de hoy.
Rana| s. Reptil de patas comestibles. El primero que las menciona en la literatura profana
Rapacidad| s. Previsión sin industria. Poder ejercido económicamente.
Ratón| s. Animal cuyo camino está sembrado de señoras desmayadas. Así como en Roma los cristianos eran arrojados a los leones
Razonable| adj. Accesible al contagio de nuestras opiniones. Receptivo a la persuasión
Razonar| v.t. Pesar probabilidades en la balanza del deseo.
Realidad| s. El sueño de un filósofo loco. Lo que queda en el filtro cuando se filtra un fantasma. El núcleo de un vacío.
Realmente| adv. Aparentemente
Rebelde| s. El que propone un nuevo desgobierno
Receta| s. Adivinanza
Recluta| s. Persona que se distingue de un civil por su uniforme
Recordar| v.t. Traer nuevamente a la memoria
Reconciliación| s. Suspensión de hostilidades. Tregua armada para desenterrar a los muertos.
Reconsiderar| v. t. Buscar una excusa para una decisión ya tomada.
Recreo| s. Clase especial de aburrimiento que alivia una fatiga general.
Rectitud| s. Virtud sólida que solía encontrarse entre los Pantidoodles
Redención| s. Exención de castigo que consiguen los pecadores asesinando al Dios contra el que pecaron. La doctrina de la Redención es el misterio fundamental de nuestra santa religión
Redundante| adj. Superfluo; innecesario; de trop
Referéndum| s. Ley que se somete a voto popular para establecer el consenso de la insensatez pública.
Reflexión| s. Proceso mental que nos da una visión más clara del pasado y nos permite eludir peligros que no volveremos a enfrentar.
Refrán| s. Dicho vulgar
Regazo| s. Uno de los más importantes órganos del cuerpo femenino
Reina| s. Mujer que gobierna el reino cuando hay un rey
Relicario| s. Receptáculo destinado a recibir objetos sagrados
Religión| s. Hija del Temor y la Esperanza
Realización| s. Muerte del esfuerzo y cuna de la repugnancia.
Reloj| s. Máquina de gran valor moral para el hombre
Rematador| s. Hombre que reafirma con un martillo que acaba de despojar una cartera con la lengua.
Renombre| s. Grado de distinción intermedio entre la notoriedad y la fama
Renta| s. Patrón de medida natural y racional de la respetabilidad.
Renunciar| v. t. Ceder un honor a cambio de una ventaja. Ceder una ventaja a cambio de otra ventaja mayor.
Reparación| s. Satisfacción que se da por un mal cometido
Réplica| s. Insulto prudente al contestar. Practicada por señores que tienen una repugnancia innata por la violencia
Reportero| s. Periodista que a fuerza de suposiciones se abre un camino hasta la verdad
Reposar| v.i. Dejar de fastidiar.
Representante| s. Miembro de la Cámara Baja en este mundo
Reprobación| s. En teología
República| s. Nación en que
República| s. Entidad administrativa manejada por una incalculable multitud de parásitos políticos
Réquiem| s. Misa de difuntos que (según nos aseguran los poetas menores) entona la brisa sobre las tumbas de sus favoritos. A veces
Rescate| s. Compra de lo que no pertenece al vendedor
Residente| s. y adj. El que no puede irse.
Respetabilidad| s. Fruto amoroso de una calva y una cuenta bancaria.
Respirador| s. Aparato ajustado sobre la nariz y la boca de un londinense para filtrar el universo visible en su paso hacia los pulmones.
Resplandeciente| adj. Dícese de un sencillo ciudadano norteamericano cuando se atavía como un duque en su logia masónica
Responder| v. t. e i. Dar respuesta
Responsabilidad| s. Carga desmontable que se traspasa fácilmente a las espaldas de Dios
Restitución| s. Fundación o sostén de universidades y bibliotecas públicas por medio de legados o donaciones.
Restitutor| s. Benefactor; filántropo.
Resuelto| adj. Dícese de quien sigue obstinadamente una línea de conducta que aprobamos.
Resultado| s. Tipo particular de desengaño. Esa clase de inteligencia que ve en la excepción la prueba de la regla
Retaguardia| s. En doctrina militar norteamericana
Revelación| s. Libro famoso en que el divino San Juan ocultó todo lo que sabía. La revelación corre por cuenta de los comentaristas
Reverencia| s. Actitud espiritual de un hombre frente a un dios
Revolución| s. En política
Rey| s. Personaje masculino al que suele llamarse en los Estados Unidos “una cabeza coronada”
Rezar| v. i. Pedir que las leyes del universo sean anuladas en beneficio de un solo peticionante
Rico| adj. Dícese del que tiene en caución
Ridículo| s. y adj. Palabra destinada a probar que la persona a quien se aplica carece de la dignidad de carácter de quien la pronuncia. Según Shaftesbury
Rima| s. Concordancia de sonidos en la punta de dos versos
Rimador| s. Poeta considerado con indiferencia o falta de estima.
Riqueza| s. Don del Cielo que significa: “Este es mi hijo bien amado
Risa| s. Convulsión interna
Rito| s. Ceremonia religiosa o semirreligiosa establecida por la ley
Ritualismo| s. Jardín de Dios donde Él puede caminar en rectilínea libertad
Ron| s. Bebida ardiente que produce locura en los abstemios.
Rostrum| s. En latín
Ruido| s. Olor nauseabundo en el oído. Música no domesticada. Principal producto y testimonio probatorio de la civilización.
Rumor| s. Arma favorita de los asesinos de reputaciones.
Ruso| s. Persona de cuerpo caucásico y alma mongólica. Emético tártaro.
Sabbath| s. Sábado para los judíos
Sabiduría| s. Tipo de ignorancia que distingue al estudioso.
Saciedad| s. Ese sentimiento
Sacerdotalista| s. El que cree que un clérigo es un sacerdote. El rechazo de esta importantísima doctrina es el desafío más audaz que han lanzado los NeoDiccionaristas al rostro de la Iglesia Episcopólica.
Sagrado| adj. Dedicado a un propósito religioso; provisto de un carácter divino; capaz de inspirar pensamientos y emociones solemnes. Por ejemplo: el Dalai Lama del Tibet; el Moogum de M’bwango; el Templo de los Monos en Ceilán; la Vaca en la India; el Cocodrilo
Sacramento| s. Solemne ceremonia religiosa a la que se atribuyen diversos grados de eficacia y significación. Roma tiene siete sacramentos
Salacidad| s. Cualidad literaria de frecuente observación en las novelas populares
Salamandra| s. Originariamente
Salsa| s. Unico signo infalible de civilización y progreso. Pueblo sin salsas
Santo| s. Pecador fallecido
Saquear| v.t. Tomar la propiedad de otro sin observar las reticencias decentes y acostumbradas del robo. Efectuar un cambio de propiedad con la cándida concomitancia de una banda militar. Apoderarse de los bienes de A y B
Sarcófago| s. Entre los griegos
Sartén| s. Instrumento de tortura usado en esa institución punitiva por excelencia
Satanás| s. Uno de los lamentables errores del Creador. Habiendo recibido la categoría de arcángel
Sátira| s. Especie de composición literaria en que los vicios y locuras de los enemigos del autor son expuestos sin demasiada ternura. En los Estados Unidos
Sátiro| s. Uno de los pocos personajes de la mitología griega cuya existencia reconoce la mitología hebrea (Levítico
Seguro| s. Ingenioso juego de azar que permite al jugador la confortable convicción de que está derrotando al que tiene la banca.
Sello| s. Marca impresa en ciertos documentos para atestiguar su autenticidad y autoridad. A veces se estampa sobre cera y se agrega al papel
Senado| s. Cuerpo de ancianos que cumple altas funciones y fechorías.
Sepulcro| s. Lugar en que se coloca a los muertos hasta que llegue el estudiante de medicina.
Sicofante| s. El que se acerca a la Grandeza de bruces para que no le ordenen dar media vuelta y recibir un puntapié. A veces es un secretario de redacción.
Silfo| s. Ser inmaterial pero visible que habitaba el aire cuando el aire era un elemento y no estaba fatalmente contaminado por el humo de las fábricas
Silogismo| s. Fórmula lógica (ver Lógica) que consiste en una premisa mayor
Símbolo| s. Algo cuya presunta función es tipificar o representar otra cosa. Muchos símbolos son meras “supervivencias”
Sirena| s. Uno de varios prodigios musicales célebres por su vana tentativa de disuadir a Odiseo de una vida oceánica. Figurativamente
Slang| s. Jerga norteamericana. Gruñido del cerdo humano (Pignoramus intolerabilis). Lenguaje del que pronuncia con la lengua lo que piensa con el oído y siente el orgullo de un creador al realizar la proeza de un loro.
Sobre| s. Ataúd de un documento; vaina de una factura; cáscara de un giro; camisón de una carta de amor.
Sofisma| s. Método de discusión de un adversario
Soga| s. Instrumento que va cayendo en desuso
Solo| adj. En mala compañíaSu (de ella)
Suficiente| adv. Todo lo que hay en el mundo
Sufragio| s. Expresión de la opinión por el voto. El derecho de sufragio (que se considera también un privilegio y un deber) significa
Superar| v.t. Hacerse de un enemigo.
Tacaño| adj. El que indebidamente quiere conservar lo que muchas personas meritorias aspiran a obtener.
Tarifa| s. Escala de impuestos a las importaciones destinada a proteger al productor local contra la avidez de sus consumidores.
Tecnicismo| s. En un tribunal inglés
Tedio| s. Ennui
Teléfono| s. Invención del demonio que suprime algunas de las ventajas de mantener a distancia a una persona desagradable.
Telescopio| s. Artefacto que tiene con el ojo una relación similar a la que tiene el teléfono con el oído
Temerario| adj. Insensible al valor de nuestros consejos.
Tenacidad| s. Cierta cualidad de la mano del hombre en su relación con la moneda corriente. Alcanza su mayor desarrollo en las manos de la autoridad
Tenedor| s. Instrumento usado principalmente para llevarse animales muertos a la boca. Antes se empleaba para ese fin el cuchillo
Teosofía| s. Antigua fe que posee toda la certidumbre de la religión y todo el misterio de la ciencia: El moderno teósofo sostiene
Tiempo| s. El clima de una hora. Permanente tema de conversación entre personas a quienes no interesa
Tierra| s. Parte de la superficie del globo
Tinta| s. Innoble compuesto de tanogalato de hierro
Tipografía| s. Pestilentes trozos de metal
Tomar| v. i. Adquirir
Tonto| s. Persona que satura el dominio de la especulación intelectual y se difunde por los canales de la actividad moral. Es omnífico
Trabajo| s. Uno de los procesos por los que A adquiere bienes para B.
Tregua| s. Amistad.
Trigo| s. Cereal del que puede extraerse un whisky tolerable
Trinidad| s. En el teísmo múltiple de ciertas iglesias cristianas
Triquinosis| s. Réplica del cerdo a la porcofagia.
Troglodita| s. Específicamente habitante de las cavernas de la era paleolítica
Tsétsé| mosca
Tumba| s. Pabellón de la Indiferencia. Actualmente el consenso general inviste a las tumbas de cierta santidad
Tumulto| s. Entretenimiento popular ofrecido a los militares por espectadores inocentes.
Turba| s. En una república
Ubicuidad| s. Don o poder de estar en todas partes en un momento dado
Ultimátum| s. En diplomacia
Unción| s. Aceitamiento o engrasamiento. El rito de la extremaunción consiste en tocar con aceite consagrado por un obispo
Ungir| v. i. Engrasar a un rey u otro gran funcionario que ya de por sí es bastante resbaloso. Los soberanos son ungidos por los sacerdotes del mismo modo que se engrasa bien a los cerdos para conducir al populacho.
Unitario| s. El que niega el dios de los Trinitarios.
Universalista| s. El que renuncia a las ventajas del Infierno en favor de los creyentes de otra religión.
Urbanidad| s. La forma más aceptable de la hipocresía. Especie de cortesía que los observadores urbanos atribuyen a los habitantes de todas las ciudades
Urraca| s. Ave cuya inclinación al robo ha sugerido a algunos la posibilidad de enseñarle a hablar.
Uso| s. Primer persona de la Trinidad literaria
Valor| s. Virtud castrense en que se mezclan la vanidad
Vanidad| s. Tributo que rinde un tonto al mérito del asno más cercano.
Valla| s. En el arte militar
Vampiro| s. Demonio que tiene la censurable costumbre de devorar los muertos. Su existencia ha sido disputada por polemistas más interesados en privar al mundo de creencias reconfortantes que de reemplazarlas por otras mejores. En 1640 el padre Sechi vio un vampiro en un cementerio próximo a Florencia y lo espantó con el signo de la cruz. Lo describe dotado de muchas cabezas y de un número extraordinario de piernas
Venganza| s. Roca natural sobre la que se alza el Templo de la Ley.
Veraz| adj. Tonto e iletrado.
Verdad| s. Ingeniosa mixtura de lo que es deseable y lo que es aparente. El descubrimiento de la verdad es el único propósito de la filosofía
Verdugo| s. Funcionario de la ley que cumple tareas de la mayor dignidad e importancia y padece un desprestigio hereditario ante un populacho de antepasados criminales. En algunos estados norteamericanos
Vida| s. Especie de salmuera espiritual que preserva al cuerpo de la descomposición. Vivimos en diario temor de perderla; cuando se pierde
Vidente| s. Persona
Viejo| adj. Estado de uso que no se contradice con una incapacidad general
Virtudes| s. p. i. Ciertas abstenciones.
Vituperio| s. Sátira
Viuda| s. Figura patética a quien el consenso del mundo cristiano toma en broma
Voto| s. Instrumento y símbolo de la facultad del hombre libre de hacer de si mismo un tonto y de su país una ruina.
Washingtoniano| s. Tribeño del Potomac que cambió las ventajas de un buen gobierno para el privilegio de gobernarse a sí mismo. Para hacerle justicia
Whhangdepootennawah| s. En el dialecto Ojibwa
Yanqui| s. En Europa
Zanzibarita| s. Habitante del Sultanato de Zanzíbar
Zenit| s. Punto del firmamento situado directamente sobre un hombre parado o un repollo que crece. No se considera que un hombre en cama o un repollo en la cacerola tengan zenit
Zoología| s. Ciencia e historia del reino animal
Zeus| s. Rey de los dioses griegos
